

Run Date,Action,Symbol,Description,Type,Quantity,Price ($),Commission ($),Fees ($),Accrued Interest ($),Amount ($),Cash Balance ($),Settlement Date
 10/22/2024," YOU BOUGHT NEXSTAR MEDIA GROUP INC COMMON STOCK (NXST) (Cash)", NXST," NEXSTAR MEDIA GROUP INC COMMON STOCK",Cash,0.133,171.34,,,,-22.79,Processing,10/23/2024
 10/22/2024," YOU BOUGHT PROLOGIS INC. COM (PLD) (Cash)", PLD," PROLOGIS INC. COM",Cash,0.244,118.76,,,,-28.98,Processing,10/23/2024
 10/22/2024," YOU BOUGHT ISHARES TR JP MOR EM MK ETF (EMB) (Cash)", EMB," ISHARES TR JP MOR EM MK ETF",Cash,0.548,91.22,,,,-49.99,Processing,10/23/2024
 10/22/2024," YOU SOLD SERVICE CORPORATION INTERNATIONAL CO... (SCI) (Cash)", SCI," SERVICE CORPORATION INTERNATIONAL COM U",Cash,-0.333,75.54,,,,25.15,Processing,10/23/2024
 10/22/2024," YOU SOLD J P MORGAN EXCHANGE TRADED FD INTL B... (JPIB) (Cash)", JPIB," J P MORGAN EXCHANGE TRADED FD INTL BD O",Cash,-0.6,47.92,,,,28.75,Processing,10/23/2024
 10/22/2024," YOU SOLD J P MORGAN EXCHANGE TRADED FD INTL B... (JPIB) (Cash)", JPIB," J P MORGAN EXCHANGE TRADED FD INTL BD O",Cash,-1,47.96,,,,47.96,Processing,10/23/2024
 10/22/2024," YOU BOUGHT ISHARES TR JP MOR EM MK ETF (EMB) (Cash)", EMB," ISHARES TR JP MOR EM MK ETF",Cash,0.915,91.16,,,,-83.41,Processing,10/23/2024
 10/22/2024," YOU SOLD SPDR BLOOMBERG SHORT TERM HIGH YIELD... (SJNK) (Cash)", SJNK," SPDR BLOOMBERG SHORT TERM HIGH YIELD BO",Cash,-0.275,25.47,,,,7,Processing,10/23/2024
 10/22/2024," YOU SOLD SPDR BLOOMBERG SHORT TERM HIGH YIELD... (SJNK) (Cash)", SJNK," SPDR BLOOMBERG SHORT TERM HIGH YIELD BO",Cash,-3,25.47,,,,76.41,Processing,10/23/2024
 10/22/2024," YOU BOUGHT ISHARES TR JP MOR EM MK ETF (EMB) (Cash)", EMB," ISHARES TR JP MOR EM MK ETF",Cash,0.315,91.19,,,,-28.72,Processing,10/23/2024
 10/22/2024," YOU BOUGHT VANECK ETF TR FALLEN ANGEL HIGH YLD ... (ANGL) (Cash)", ANGL," VANECK ETF TR FALLEN ANGEL HIGH YLD BD ",Cash,0.723,29.02,,,,-20.98,Processing,10/23/2024
 10/22/2024," YOU SOLD BERKSHIRE HATHAWAY INC COM USD0.0033... (BRKB) (Cash)", BRKB," BERKSHIRE HATHAWAY INC COM USD0.0033 CL",Cash,-0.108,460.3,,,,49.71,Processing,10/23/2024
 10/21/2024," YOU SOLD WD 40 CO COM (WDFC) (Cash)", WDFC," WD 40 CO COM",Cash,-0.199,256.47,,,,51.04,0.00,10/22/2024
 10/21/2024," YOU SOLD VANGUARD SCOTTSDALE FDS VANGUARD SHO... (VCSH) (Cash)", VCSH," VANGUARD SCOTTSDALE FDS VANGUARD SHORT-",Cash,-0.713,78.64,,,,56.07,-51.04,10/22/2024
 10/21/2024," YOU BOUGHT VANECK ETF TR FALLEN ANGEL HIGH YLD ... (ANGL) (Cash)", ANGL," VANECK ETF TR FALLEN ANGEL HIGH YLD BD ",Cash,1,29.09,,,,-29.09,-107.11,10/22/2024
 10/21/2024," YOU BOUGHT VANECK ETF TR FALLEN ANGEL HIGH YLD ... (ANGL) (Cash)", ANGL," VANECK ETF TR FALLEN ANGEL HIGH YLD BD ",Cash,1,29.1,,,,-29.1,-78.02,10/22/2024
 10/21/2024," YOU BOUGHT PETROLEO BRASILEIRO SA PETROBRAS SPO... (PBR) (Cash)", PBR," PETROLEO BRASILEIRO SA PETROBRAS SPON A",Cash,0.43,13.95,,,,-6,-48.92,10/22/2024
 10/21/2024," YOU BOUGHT ISHARES TR JP MOR EM MK ETF (EMB) (Cash)", EMB," ISHARES TR JP MOR EM MK ETF",Cash,0.333,91.47,,,,-30.46,-42.92,10/22/2024
 10/21/2024," YOU BOUGHT PROSPECTUS UNDER SEPARATE COVER FID L/T TREASURY BOND INDEX FUND (FNBGX) (Cash)", FNBGX," FID L/T TREASURY BOND INDEX FUND",Cash,15.006,9.6,,,,-144.06,-12.46,10/22/2024
 10/21/2024," YOU SOLD BERKSHIRE HATHAWAY INC COM USD0.0033... (BRKB) (Cash)", BRKB," BERKSHIRE HATHAWAY INC COM USD0.0033 CL",Cash,-0.107,463.58,,,,49.6,131.60,10/22/2024
 10/21/2024," YOU BOUGHT LYONDELLBASELL INDUSTRIES N V COM EU... (LYB) (Cash)", LYB," LYONDELLBASELL INDUSTRIES N V COM EUR0.",Cash,0.066,89.81,,,,-5.93,82.00,10/22/2024
 10/21/2024," YOU SOLD GAMBLING.COM GROUP LIMITED ORD NPV (GAMB) (Cash)", GAMB," GAMBLING.COM GROUP LIMITED ORD NPV",Cash,-1,9.77,,,,9.77,87.93,10/22/2024
 10/21/2024," YOU SOLD GAMBLING.COM GROUP LIMITED ORD NPV (GAMB) (Cash)", GAMB," GAMBLING.COM GROUP LIMITED ORD NPV",Cash,-8,9.77,,,,78.16,78.16,10/22/2024
 10/18/2024," YOU BOUGHT TESLA INC COM (TSLA) (Cash)", TSLA," TESLA INC COM",Cash,0.11,220.78,,,,-24.29,0.00,10/21/2024
 10/18/2024," YOU SOLD QUEST DIAGNOSTICS INC COM USD0.01 (DGX) (Cash)", DGX," QUEST DIAGNOSTICS INC COM USD0.01",Cash,-0.084,148.26,,,,12.45,24.29,10/21/2024
 10/18/2024," YOU SOLD ETFS GOLD TR PHYSCL GOLD SHS (SGOL) (Cash)", SGOL," ETFS GOLD TR PHYSCL GOLD SHS",Cash,-0.455,25.91,,,,11.79,11.84,10/21/2024
 10/17/2024," YOU SOLD UNITED STS LIME &MINERALS INC COM (USLM) (Cash)", USLM," UNITED STS LIME &MINERALS INC COM",Cash,-0.096,103.45,,,,9.93,0.05,10/18/2024
 10/17/2024," YOU BOUGHT TESLA INC COM (TSLA) (Cash)", TSLA," TESLA INC COM",Cash,0.1,220.63,,,,-22.06,-9.88,10/18/2024
 10/17/2024," YOU BOUGHT TESLA INC COM (TSLA) (Cash)", TSLA," TESLA INC COM",Cash,0.091,221.35,,,,-20.14,12.18,10/18/2024
 10/17/2024," YOU BOUGHT TESLA INC COM (TSLA) (Cash)", TSLA," TESLA INC COM",Cash,0.046,220.19,,,,-10.13,32.32,10/18/2024
 10/17/2024," YOU SOLD SPDR BLOOMBERG SHORT TERM HIGH YIELD... (SJNK) (Cash)", SJNK," SPDR BLOOMBERG SHORT TERM HIGH YIELD BO",Cash,-0.391,25.53,,,,9.98,42.45,10/18/2024
 10/17/2024," YOU BOUGHT PALO ALTO NETWORKS INC COM USD0.0001 (PANW) (Cash)", PANW," PALO ALTO NETWORKS INC COM USD0.0001",Cash,0.018,376.91,,,,-6.78,32.47,10/18/2024
 10/17/2024," YOU BOUGHT INVESCO DB MULTI-SECTOR COMMOD BASE ... (DBB) (Cash)", DBB," INVESCO DB MULTI-SECTOR COMMOD BASE MET",Cash,0.491,20.34,,,,-9.99,39.25,10/18/2024
 10/17/2024," YOU SOLD INVESCO ACTVELY MNGD ETC FD TR OPTIM... (PDBC) (Cash)", PDBC," INVESCO ACTVELY MNGD ETC FD TR OPTIMUM ",Cash,-0.501,13.5,,,,6.76,49.24,10/18/2024
 10/17/2024," YOU SOLD INVESCO ACTVELY MNGD ETC FD TR OPTIM... (PDBC) (Cash)", PDBC," INVESCO ACTVELY MNGD ETC FD TR OPTIMUM ",Cash,-1,13.5,,,,13.5,42.48,10/18/2024
 10/17/2024," YOU SOLD FLEXSHARES IBOXX 5-YEAR TARG (TDTF) (Cash)", TDTF," FLEXSHARES IBOXX 5-YEAR TARG",Cash,-0.797,23.82,,,,18.98,28.98,10/18/2024
 10/17/2024," YOU SOLD BOOZ ALLEN HAMILTON HLDG CORP CL A (BAH) (Cash)", BAH," BOOZ ALLEN HAMILTON HLDG CORP CL A",Cash,-0.061,163.69,,,,9.99,10.00,10/18/2024
 10/16/2024," YOU SOLD VANECK ETF TR FALLEN ANGEL HIGH YLD ... (ANGL) (Cash)", ANGL," VANECK ETF TR FALLEN ANGEL HIGH YLD BD ",Cash,-0.916,29.22,,,,26.77,0.01,10/17/2024
 10/16/2024," YOU BOUGHT TRANSPORTADORA DE GAS DEL SUR S.A SP... (TGS) (Cash)", TGS," TRANSPORTADORA DE GAS DEL SUR S.A SPONS",Cash,3,20.53,,,,-61.59,-26.76,10/17/2024
 10/16/2024," YOU BOUGHT TRANSPORTADORA DE GAS DEL SUR S.A SP... (TGS) (Cash)", TGS," TRANSPORTADORA DE GAS DEL SUR S.A SPONS",Cash,0.11,20.53,,,,-2.26,34.83,10/17/2024
 10/16/2024," YOU BOUGHT TESLA INC COM (TSLA) (Cash)", TSLA," TESLA INC COM",Cash,0.056,221.68,,,,-12.41,37.09,10/17/2024
 10/16/2024," YOU SOLD PROLOGIS INC. COM (PLD) (Cash)", PLD," PROLOGIS INC. COM",Cash,-0.141,126.89,,,,17.89,49.50,10/17/2024
 10/16/2024," YOU SOLD NEXSTAR MEDIA GROUP INC COMMON STOCK (NXST) (Cash)", NXST," NEXSTAR MEDIA GROUP INC COMMON STOCK",Cash,-0.164,170.47,,,,27.96,31.61,10/17/2024
 10/16/2024," YOU SOLD EX-DIV DATE 10/21/24RECORD DATE 10/21/24PAYABLE DTE 10/25/24 INVESCO EXCH TRADED FD TR II GLOBAL ... (PGHY) (Cash)", PGHY," INVESCO EXCH TRADED FD TR II GLOBAL EX ",Cash,-0.946,20.21,,,,19.12,3.65,10/17/2024
 10/16/2024," YOU SOLD DONNELLEY FINL SOLUTIONS INC COM (DFIN) (Cash)", DFIN," DONNELLEY FINL SOLUTIONS INC COM",Cash,-0.322,66.65,,,,21.46,-15.47,10/17/2024
 10/16/2024," YOU BOUGHT CARRIER GLOBAL CORPORATION COM (CARR) (Cash)", CARR," CARRIER GLOBAL CORPORATION COM",Cash,0.343,81.53,,,,-27.96,-36.93,10/17/2024
 10/16/2024," YOU BOUGHT CARRIER GLOBAL CORPORATION COM (CARR) (Cash)", CARR," CARRIER GLOBAL CORPORATION COM",Cash,0.11,81.64,,,,-8.98,-8.97,10/17/2024
 10/15/2024," YOU BOUGHT TESLA INC COM (TSLA) (Cash)", TSLA," TESLA INC COM",Cash,0.053,220.24,,,,-11.67,0.01,10/16/2024
 10/15/2024," YOU BOUGHT SS&C TECHNOLOGIES HLDGS INC COM (SSNC) (Cash)", SSNC," SS&C TECHNOLOGIES HLDGS INC COM",Cash,0.221,76.71,,,,-16.95,11.68,10/16/2024
 10/15/2024," YOU SOLD PROLOGIS INC. COM (PLD) (Cash)", PLD," PROLOGIS INC. COM",Cash,-0.107,121.76,,,,13.03,28.63,10/16/2024
 10/15/2024," YOU SOLD IRADIMED CORP (IRMD) (Cash)", IRMD," IRADIMED CORP",Cash,-0.646,50.46,,,,32.6,15.60,10/16/2024
 10/15/2024," YOU BOUGHT INTERPARFUMS, INC. COMMON STOCK (IPAR) (Cash)", IPAR," INTERPARFUMS, INC. COMMON STOCK",Cash,0.108,120.66,,,,-13.03,-17.00,10/16/2024
 10/15/2024," YOU BOUGHT INTERPARFUMS, INC. COMMON STOCK (IPAR) (Cash)", IPAR," INTERPARFUMS, INC. COMMON STOCK",Cash,0.049,120.27,,,,-5.89,-3.97,10/16/2024
 10/15/2024," YOU BOUGHT FIRST TR EXCHANGE TRADED FD III FIRS... (FPE) (Cash)", FPE," FIRST TR EXCHANGE TRADED FD III FIRST T",Cash,0.385,18.15,,,,-6.99,1.92,10/16/2024
 10/15/2024," YOU SOLD ETFS GOLD TR PHYSCL GOLD SHS (SGOL) (Cash)", SGOL," ETFS GOLD TR PHYSCL GOLD SHS",Cash,-0.35,25.44,,,,8.9,8.91,10/16/2024
 10/14/2024," YOU BOUGHT VANGUARD SCOTTSDALE FDS VANGUARD SHO... (VCSH) (Cash)", VCSH," VANGUARD SCOTTSDALE FDS VANGUARD SHORT-",Cash,0.551,78.71,,,,-43.37,0.01,10/15/2024
 10/14/2024," YOU BOUGHT VANGUARD SCOTTSDALE FDS VANGUARD SHO... (VCSH) (Cash)", VCSH," VANGUARD SCOTTSDALE FDS VANGUARD SHORT-",Cash,0.317,78.71,,,,-24.95,43.38,10/15/2024
 10/14/2024," YOU SOLD UNITED STS LIME &MINERALS INC COM (USLM) (Cash)", USLM," UNITED STS LIME &MINERALS INC COM",Cash,-0.35,101.01,,,,35.35,68.33,10/15/2024
 10/14/2024," YOU SOLD UNITED STS LIME &MINERALS INC COM (USLM) (Cash)", USLM," UNITED STS LIME &MINERALS INC COM",Cash,-0.43,100.86,,,,43.37,32.98,10/15/2024
 10/14/2024," YOU BOUGHT SERVICE CORPORATION INTERNATIONAL CO... (SCI) (Cash)", SCI," SERVICE CORPORATION INTERNATIONAL COM U",Cash,0.513,75.49,,,,-38.73,-10.39,10/15/2024
 10/14/2024," YOU SOLD PROLOGIS INC. COM (PLD) (Cash)", PLD," PROLOGIS INC. COM",Cash,-0.182,120.88,,,,22,28.34,10/15/2024
 10/14/2024," YOU SOLD IES HLDGS INC COM (IESC) (Cash)", IESC," IES HLDGS INC COM",Cash,-0.064,232.52,,,,14.88,6.34,10/15/2024
 10/14/2024," YOU SOLD FORTIS INC COM ISIN #CA3495531079 SE... (FTS) (Cash)", FTS," FORTIS INC COM ISIN #CA3495531079 SEDOL",Cash,-0.283,43.68,,,,12.36,-8.54,10/15/2024
 10/14/2024," YOU BOUGHT FIRST AMERICAN FINANCIAL CORP (FAF) (Cash)", FAF," FIRST AMERICAN FINANCIAL CORP",Cash,0.419,65.01,,,,-27.24,-20.90,10/15/2024
 10/14/2024," YOU BOUGHT FIRST AMERICAN FINANCIAL CORP (FAF) (Cash)", FAF," FIRST AMERICAN FINANCIAL CORP",Cash,0.287,64.97,,,,-18.65,6.34,10/15/2024
 10/14/2024," YOU SOLD ETFS GOLD TR PHYSCL GOLD SHS (SGOL) (Cash)", SGOL," ETFS GOLD TR PHYSCL GOLD SHS",Cash,-0.984,25.39,,,,24.98,24.99,10/15/2024
 10/10/2024," YOU BOUGHT J P MORGAN EXCHANGE TRADED FD INTL B... (JPIB) (Cash)", JPIB," J P MORGAN EXCHANGE TRADED FD INTL BD O",Cash,2,47.97,,,,-95.95,0.01,10/11/2024
 10/10/2024," YOU BOUGHT J P MORGAN EXCHANGE TRADED FD INTL B... (JPIB) (Cash)", JPIB," J P MORGAN EXCHANGE TRADED FD INTL BD O",Cash,0.256,47.99,,,,-12.28,95.96,10/11/2024
 10/01/2024," YOU SOLD UNITED STS LIME &MINERALS INC COM (USLM) (Cash)", USLM," UNITED STS LIME &MINERALS INC COM",Cash,-0.2,95.59,,,,19.12,5.24,10/02/2024
 10/01/2024," YOU BOUGHT QUEST DIAGNOSTICS INC COM USD0.01 (DGX) (Cash)", DGX," QUEST DIAGNOSTICS INC COM USD0.01",Cash,0.09,154.31,,,,-13.89,-13.88,10/02/2024
 09/30/2024," YOU BOUGHT TRANSPORTADORA DE GAS DEL SUR S.A SP... (TGS) (Cash)", TGS," TRANSPORTADORA DE GAS DEL SUR S.A SPONS",Cash,1,18.71,,,,-18.71,0.01,10/01/2024
 09/30/2024," YOU BOUGHT TRANSPORTADORA DE GAS DEL SUR S.A SP... (TGS) (Cash)", TGS," TRANSPORTADORA DE GAS DEL SUR S.A SPONS",Cash,1,18.84,,,,-18.84,18.72,10/01/2024
 09/30/2024," YOU BOUGHT PROLOGIS INC. COM (PLD) (Cash)", PLD," PROLOGIS INC. COM",Cash,0.087,125.66,,,,-10.93,37.56,10/01/2024
 09/30/2024," YOU BOUGHT PALO ALTO NETWORKS INC COM USD0.0001 (PANW) (Cash)", PANW," PALO ALTO NETWORKS INC COM USD0.0001",Cash,0.017,340.94,,,,-5.8,48.49,10/01/2024
 09/30/2024," YOU SOLD IRADIMED CORP (IRMD) (Cash)", IRMD," IRADIMED CORP",Cash,-0.2,49.9,,,,9.98,54.29,10/01/2024
 09/30/2024," YOU SOLD GILEAD SCIENCES INC COM USD0.001 (GILD) (Cash)", GILD," GILEAD SCIENCES INC COM USD0.001",Cash,-0.469,83.53,,,,39.18,44.31,10/01/2024
 09/30/2024," YOU BOUGHT GAMBLING.COM GROUP LIMITED ORD NPV (GAMB) (Cash)", GAMB," GAMBLING.COM GROUP LIMITED ORD NPV",Cash,2,10.15,,,,-20.3,5.13,10/01/2024
 09/30/2024," YOU BOUGHT GAMBLING.COM GROUP LIMITED ORD NPV (GAMB) (Cash)", GAMB," GAMBLING.COM GROUP LIMITED ORD NPV",Cash,0.404,10.13,,,,-4.09,25.43,10/01/2024
 09/27/2024," YOU SOLD WD 40 CO COM (WDFC) (Cash)", WDFC," WD 40 CO COM",Cash,-0.034,260,,,,8.84,0.01,09/30/2024
 09/27/2024," YOU BOUGHT VANGUARD SCOTTSDALE FDS VANGUARD SHO... (VCSH) (Cash)", VCSH," VANGUARD SCOTTSDALE FDS VANGUARD SHORT-",Cash,0.138,79.45,,,,-10.96,-8.83,09/30/2024
 09/27/2024," YOU SOLD SERVICE CORPORATION INTERNATIONAL CO... (SCI) (Cash)", SCI," SERVICE CORPORATION INTERNATIONAL COM U",Cash,-0.114,78.9,,,,8.99,2.13,09/30/2024
 09/27/2024," YOU BOUGHT FLEXSHARES IBOXX 5-YEAR TARG (TDTF) (Cash)", TDTF," FLEXSHARES IBOXX 5-YEAR TARG",Cash,0.286,24.1,,,,-6.89,-6.86,09/30/2024
 09/26/2024," YOU BOUGHT VANGUARD SCOTTSDALE FDS VANGUARD SHO... (VCSH) (Cash)", VCSH," VANGUARD SCOTTSDALE FDS VANGUARD SHORT-",Cash,0.168,79.37,,,,-13.33,0.03,09/27/2024
 09/26/2024," YOU BOUGHT SPDR BLOOMBERG SHORT TERM HIGH YIELD... (SJNK) (Cash)", SJNK," SPDR BLOOMBERG SHORT TERM HIGH YIELD BO",Cash,0.389,25.66,,,,-9.98,13.36,09/27/2024
 09/26/2024," YOU BOUGHT QUEST DIAGNOSTICS INC COM USD0.01 (DGX) (Cash)", DGX," QUEST DIAGNOSTICS INC COM USD0.01",Cash,0.045,153.08,,,,-6.89,23.34,09/27/2024
 09/26/2024," YOU BOUGHT PROLOGIS INC. COM (PLD) (Cash)", PLD," PROLOGIS INC. COM",Cash,0.111,125.56,,,,-13.94,30.23,09/27/2024
 09/26/2024," YOU BOUGHT NATIONAL HEALTHCARE CORP (NHC) (Cash)", NHC," NATIONAL HEALTHCARE CORP",Cash,0.119,125.13,,,,-14.89,44.17,09/27/2024
 09/26/2024," YOU BOUGHT J P MORGAN EXCHANGE TRADED FD INTL B... (JPIB) (Cash)", JPIB," J P MORGAN EXCHANGE TRADED FD INTL BD O",Cash,0.431,48.63,,,,-20.96,59.06,09/27/2024
 09/26/2024," YOU BOUGHT ISHARES TR JP MOR EM MK ETF (EMB) (Cash)", EMB," ISHARES TR JP MOR EM MK ETF",Cash,0.064,93.07,,,,-5.96,80.02,09/27/2024
 09/26/2024," YOU BOUGHT INGLES MARKETS INC (IMKTA) (Cash)", IMKTA," INGLES MARKETS INC",Cash,0.122,73.43,,,,-8.96,85.98,09/27/2024
 09/26/2024," YOU SOLD IES HLDGS INC COM (IESC) (Cash)", IESC," IES HLDGS INC COM",Cash,-0.051,192.99,,,,9.84,94.94,09/27/2024
 09/26/2024," YOU BOUGHT FORTIS INC COM ISIN #CA3495531079 SE... (FTS) (Cash)", FTS," FORTIS INC COM ISIN #CA3495531079 SEDOL",Cash,0.263,45.49,,,,-11.96,85.10,09/27/2024
 09/26/2024," YOU BOUGHT FIRST AMERICAN FINANCIAL CORP (FAF) (Cash)", FAF," FIRST AMERICAN FINANCIAL CORP",Cash,0.092,64.76,,,,-5.96,97.06,09/27/2024
 09/25/2024," YOU BOUGHT FLEXSHARES IBOXX 5-YEAR TARG (TDTF) (Cash)", TDTF," FLEXSHARES IBOXX 5-YEAR TARG",Cash,0.588,24.14,,,,-14.19,0.02,09/26/2024
 09/24/2024," YOU SOLD WD 40 CO COM (WDFC) (Cash)", WDFC," WD 40 CO COM",Cash,-0.051,256.67,,,,13.09,14.21,09/25/2024
 09/24/2024," YOU BOUGHT PROLOGIS INC. COM (PLD) (Cash)", PLD," PROLOGIS INC. COM",Cash,0.049,126.68,,,,-6.21,1.12,09/25/2024
 09/24/2024," YOU BOUGHT NEXSTAR MEDIA GROUP INC COMMON STOCK (NXST) (Cash)", NXST," NEXSTAR MEDIA GROUP INC COMMON STOCK",Cash,0.041,168.17,,,,-6.89,7.33,09/25/2024
 09/24/2024," YOU BOUGHT NEXSTAR MEDIA GROUP INC COMMON STOCK (NXST) (Cash)", NXST," NEXSTAR MEDIA GROUP INC COMMON STOCK",Cash,0.04,167.84,,,,-6.71,14.22,09/25/2024
 09/24/2024," YOU SOLD IRADIMED CORP (IRMD) (Cash)", IRMD," IRADIMED CORP",Cash,-0.448,48.52,,,,21.74,20.93,09/25/2024
 09/24/2024," YOU SOLD FIDELITY DIVIDEND GROWTH (FDGFX) (Cash)", FDGFX," FIDELITY DIVIDEND GROWTH",Cash,-0.368,38.42,,,,14.14,-0.81,09/25/2024
 09/24/2024," YOU BOUGHT BRT APARTMENTS CORP COM (BRT) (Cash)", BRT," BRT APARTMENTS CORP COM",Cash,0.822,18.24,,,,-14.99,-14.95,09/25/2024
 09/23/2024," YOU SOLD VULCAN MATERIALS CO (VMC) (Cash)", VMC," VULCAN MATERIALS CO",Cash,-0.128,253.11,,,,32.4,0.04,09/24/2024
 09/23/2024," YOU BOUGHT QUEST DIAGNOSTICS INC COM USD0.01 (DGX) (Cash)", DGX," QUEST DIAGNOSTICS INC COM USD0.01",Cash,0.077,154.29,,,,-11.88,-32.36,09/24/2024
 09/23/2024," YOU BOUGHT PROLOGIS INC. COM (PLD) (Cash)", PLD," PROLOGIS INC. COM",Cash,0.098,126.6,,,,-12.41,-20.48,09/24/2024
 09/23/2024," YOU BOUGHT NEXSTAR MEDIA GROUP INC COMMON STOCK (NXST) (Cash)", NXST," NEXSTAR MEDIA GROUP INC COMMON STOCK",Cash,0.037,165.44,,,,-6.12,-8.07,09/24/2024
 09/23/2024," YOU BOUGHT INGLES MARKETS INC (IMKTA) (Cash)", IMKTA," INGLES MARKETS INC",Cash,0.124,72.42,,,,-8.98,-1.95,09/24/2024
 09/23/2024," YOU SOLD FORTIS INC COM ISIN #CA3495531079 SE... (FTS) (Cash)", FTS," FORTIS INC COM ISIN #CA3495531079 SEDOL",Cash,-0.338,45.03,,,,15.22,7.03,09/24/2024
 09/23/2024," YOU BOUGHT FIRST AMERICAN FINANCIAL CORP (FAF) (Cash)", FAF," FIRST AMERICAN FINANCIAL CORP",Cash,0.126,65.04,,,,-8.2,-8.19,09/24/2024



"The data and information in this spreadsheet is provided to you solely for your use and is not for distribution. The spreadsheet is provided for"
"informational purposes only, and is not intended to provide advice, nor should it be construed as an offer to sell, a solicitation of an offer to buy or a"
"recommendation for any security or insurance product by Fidelity or any third party. Data and information shown is based on information known to Fidelity as of the date it was"
"exported and is subject to change. It should not be used in place of your account statements or trade confirmations and is not intended for tax reporting"
"purposes. For more information on the data included in this spreadsheet, including any limitations thereof, go to Fidelity.com."

"Brokerage services are provided by Fidelity Brokerage Services LLC (FBS), 900 Salem Street, Smithfield, RI 02917. Custody and other services provided by National"
"Financial Services LLC (NFS). Both are Fidelity Investment companies and members SIPC, NYSE. Insurance products at Fidelity are distributed by"
"Fidelity Insurance Agency, Inc., and, for certain products, by Fidelity Brokerage Services, Member NYSE, SIPC."

Date downloaded 10/22/2024 3:40 pm